1111111111111111111111111111111111
1P0001000100010C0100010001000100E1
1010010001000100010001000100010101
10100100C100010001000100C100010101
1010010001000100010001000100010101
1111111111111111111111111111111101
10C00000000C0000000000C00000000C01
1010101010101010101010101010101101
1000101010001010100010101000101001
100010101000101010001C1010001010C1
1111111111111111111111111111111111
