1111111111111111111111111111111111
10P000C00000000C000000000000000001
1000000000000000000000000000000001
10000C00011111111111100000C0000001
1000000001E000C0000100000000000001
1000000001000000000100000000000001
10000C0001000C00000100000000000001
1000000001111111111100000000000001
100000000000000000000000C000000001
10000C00000000000000000000000C0001
1111111111111111111111111111111111
