1111111111111111111111111111111111
1P00001000000100C00000100000000001
1010101010101010101010101010101101
10C0101000001000001000000010100001
1010101011111111111111111010111101
10100000000000000000000010C0100001
1011111111111111111111110101011101
100000000C00100000000000101010C001
1010101010101011111111111010101001
10C01010100000000000000010001010E1
1111111111111111111111111111111111
