1111111111111111111111111111111111
1P0000000C00C0000C00001111111111111
1010010100100000101001111E000000C1
1010010010101010001001111000000001
10000C0000000000000001111000C00001
1111111111111111111111111111111111
