1111111111111111111111111111111111
1P0000000C00000000000000C000000001
1011111111111111111111111111111101
10100000000000000000000000000001C1
1010111111111111111111111111110101
101010000C00000000000000000001C101
10101011111111111111111111110101C1
1010100000000000E000000000001010C1
101010111111111111111111111010101C1
10C010000000C0000000000000010101C1
1111111111111111111111111111111111
