1111111111111111111111111111111111
1E000000000000000000000000000000C1
1011111111111111111111111111111101
1C00d000000000000000000000000000C1
1011111111111111111111111111111101
1C000000000000000000000000000d00C1
1011111111111111111111111111111101
1P000000000000000000000000000000C1
1111111111111111111111111111111111