11111111111
10000000001
1E000000001
11111111111
1P0000000C1
10000000001
11111111111