IIIIIIIIIIIIIIIIIIIIIIIIIIIIIIIIII
IE0000000000000C00000C00000000000I
I0I00I0I00I00000I0I00I0000000I0I0I
I0I00I00I0I0I0I000I00I0000000I0I0I
IP0000000C00C0000000000000000000CI
IIIIIIIIIIIIIIIIIIIIIIIIIIIIIIIIII