11111111111
1P0C0100001
10000100001
10000100E01
10C00100001
10000100001
11111111111